S S SS S X   S      
         X  S S  S S
  S S    X  S       
  S   S  X  S S  S  
    S    X          
  S  S   XXXXXXXXXXX
 S    S      S  X   
         SS    XX   
XXXXXXXXXXXXXXXXX  S
  S    S  X S     S 
          X         
    S     X   S   S 
   S  S   X         
          X  SS  S  
   SS     X     S   
  SSSS    W  S S     
 SSSSSS        S    
  SSS S    SS    S  
 S      S S    S SS 
     S  S   S S S  S
